11111111111111111111111111111111
10000000000000000000000000000001
11111111111111111111111111111111
1P0010000100C0CC00100C0100000001
11100101011101CC1010010101111101
1C110101010C11CG1011010101E11101
100000010C00C0CC10000100010000C1
11111111111111111111111111111111
